%%%%%%%%%
%GP     %
%.     .%
%%%%%%%%%