%%%%%
%% P%
%  %%
%%  %
%%%%%
