%%%%%
%  P%
% % %
%   %
%%%%%
