%%%%%%
%   P%
% %% %
% %  %
%    %
%%%%%%
