%%%%%
% %P%
% % %
% % %
%   %
%%%%%