%%%%%%%%%
%.......%
%%%%.%% %
%   P   %
%%%%%%%%%