%%%%%
%% %%
%% %%
% P %
%%%%%
