%%%%%%%%%%%%%%%%%%%%%%%%%
% P....      ....    .. %
% ..  ...  ...  ...  .. %
%     ...  ...  ...  .. %
%    ...     .... G  .. %
%   ...    ...  ...  .. %
%  ...     ...  ...  .. %
% .......    ....    ..o%
%%%%%%%%%%%%%%%%%%%%%%%%%
