%%%%%
%  .%
% G %
%  P%
%%%%%
