%%%%%
%...%
%.G.%
%..P%
%%%%%
