%%%%%
%  .%
%  G%
%  P%
%%%%%
