%%%%%%%%%
%..G  ..%
%%%%.%% %
%   P   %
%.%% %%.%
%.%.G  .%
%%%%%%%%%
