%%%%%%%%%
%..G  ..%
%%%%.%% %
%   P   %
%.%% %%.%
%.%.   .%
%%%%%%%%%
