%%%%%%%%%%%%%
% %%        %
%    %%%%%% %
%%%%%%     P%
%    % %%%%%%
% %%%% %    %
%        %%%%
%%%%  %%%%  %
%.         %%
%%%%%%%%%%%%%